NO ./textures/north.xpm
SO ./textures/south.xpm
WE ./textures/west.xpm
EA ./textures/east.xpm
F 110,110,110
C 135,206,235

111111111111111111111
100000000000000000001
10000000M000000000001
111111111111000000001
100000000000000000011
10001111D111110111101
100010000000000000001
101010011101110100111
100000000100000000001
100M001101110111111D1
1000000000000D00000N1
111111111111111111111